WWWWWWWWWWWWWWWWWWWWWWWWWWWWWWWWWWWWWW
WDDDDDDDDDDDWDDDDDDDDDDWDDDWDDDDDDDDDW
WDWDWWWWWWWDWDWDWDWWWWDWDWDWDWWWWWDWDW
WDDDDDDDDDDDDDDDDDDDDDDWDDDDDDDDDDDDDW
WWWDWWWWDWWWDWWDWWDWWWDWDWWWWDWWWWDWWW
  WDWDDDDWDDD     DWDWDWDDDDWDW  WDW  
WWWDWDDDDWWWDWWWWWDDDWDWDWWWWDWWWWDWWW
   DWDDDDDDWDDDDDDDDDWDDDWDDDDW  WD   
WWWDWWWWDWWWDWWWWWDWWWWWDWWWWDWWWWDWWW
  WDDDDDDDDDDDWDWDDDDDDDDDDDDDDDDDDW  
  WDDWWWWWWDWDWDWDDWWWWWWWDWDWWWDWWW  
  WDDDDDDDDDWDDDDDDDDDDDDDDWDDDDDDDW  
WWWWWWWWWWWWWWWWWWWWWWWWWWWWWWWWWWWWWW