WWWWWWWWWWWWWWWWWWWWWWWWWWWWWWWWWWWWWW
WDDDDDDDDDDDWDDDDDDDDDDWDDDWDDDDDDDDDW
WDWDWWWWWWWDWDWDWDWWWWDWDWDWDWWWWWDWDW
WDDDDDDDDDDDDDDDDDDDDDDWDDDDDDDDDDDDDW
WWWDWWWWDWWWDWWWWWDWWWDWDWWWWDWWWWDWWW
  WDWDDDDWDDDW   WDWDWDWDDDDWDW  WDW  
WWWDWDDDDWWWDWWWWWDDDWDWDWWWWDWWWWDWWW
   DWDDDDDDWDDDDDDDDDWDDDWDDDDW  WD   
WWWDWWWWDWWWDWWWWWDWWWWWDWWWWDWWWWDWWW
  WDDDDDDDDDDDWDWDDDDDDDDDDDDDDDDDDW  
  WDDWWWWWWDWDWDWWDWWWWWWWDWDWWWDWWW  
  WDDDDDDDDDWDDDDDDDDDDDDDDWDDDDDDDW  
WWWWWWWWWWWWWWWWWWWWWWWWWWWWWWWWWWWWWW